10
10
Test Map

LLLLSLLLLL
LRLLLLLLRL
LLLLLLLLLL
LLLLRLLLLL
LLLLLLLLLL
LLLLLLLLLL
LLLLRLLLLL
LLLLLLLLLL
LLLLLLRLLL
LLLLLLLLFL